10 10
22
1111111111
1000000001
1000000001
1000011111
1000010001
1000000001
1111000001
1000000111
1000000001
1111111111