10 10
5
1111111111
1000000001
1000000001
1000000001
1000000001
1000000001
1111000001
1000000001
1000000001
1111111111